111111111111111111111111111111
100000000000000000000000000001
100010000000000000000000000001
111110000000000000000000000001
100000000000000010000000000001
100000000000000011111111111111
100000000000111000000000000001
100000000000100000000000000001
100000000000111111111100000001
100011011000000000000100000001
100010001000000000000100000001
100010001000111111111111110001
100011111000100000000000000001
100000000000100000000000000001
100000000000100000001000000001
111111111111111111111111111111